itest
An Interactive Fiction by Ben Leiken The White Room is a room with a door to the east "The description of The White Room is black curtains near the station. Black-roof country, no gold pavements, tired starlings. Silver horses run down moonbeams on your eyes. East is The Garden of Eden."
Release 1 / Serial number 120224 / Inform 7 build 6G60 (I6/v6.32 lib 6/12N) SD

White Room

>go east
Garden of Eden

>look
Garden of Eden

>go west
White Room

>look
White Room

>look
White Room

* * *

>go east
Garden of Eden

>go west
The White Room

>go east
Garden of Eden

* * *

itest
An Interactive Fiction by Ben Leiken The White Room is a room with a door to the east "The description of The White Room is black curtains near the station. Black-roof country, no gold pavements, tired starlings. Silver horses run down moonbeams on your eyes. East is The Garden of Eden."
Release 1 / Serial number 120224 / Inform 7 build 6G60 (I6/v6.32 lib 6/12N) SD

White Room

>look around
You can't see any such thing.

>look
Garden of Eden

>pavements
That's not a verb I recognise.

>inspect
That's not a verb I recognise.

* * *

itest
An Interactive Fiction by Ben Leiken The White Room is a room with a door to the east "The description of The White Room is black curtains near the station. Black-roof country, no gold pavements, tired starlings. Silver horses run down moonbeams on your eyes. East is The Garden of Eden."
Release 1 / Serial number 120224 / Inform 7 build 6G60 (I6/v6.32 lib 6/12N) SD

White Room

>look
White Room

* * *

itest
An Interactive Fiction by Ben Leiken The White Room is a room with a door to the east "The description of The White Room is black curtains near the station. Black-roof country, no gold pavements, tired starlings. Silver horses run down moonbeams on your eyes. East is The Garden of Eden."
Release 1 / Serial number 120224 / Inform 7 build 6G60 (I6/v6.32 lib 6/12N) SD

White Room

>go south
You can't go that way.