You are a Macrophage named Phil. You live inside of Ming Chow. Ming has a brain aneurysm. His life is in YOUR flagelli (hands). You must save him before his time runs out!

Hemorrhage
An Interactive Fiction by Ben Leiken
Release 1 / Serial number 120313 / Inform 7 build 6G60 (I6/v6.32 lib 6/12N) SD

Left Atrium
The Atrium pulsates all around you, pumping red and white blood cells, platelets, and plasma southward towards the Right Ventricle.

You can see a Mitral Valve and an Electrostatic Stimulator here.

>wire the mitral valve
That's not a verb I recognise.

>wiring
That's not a verb I recognise.

>take stimulator
Taken.

* * *

You are a Macrophage named Phil. You live inside of Ming Chow. Ming has a brain aneurysm. His life is in YOUR flagelli (hands). You must save him before his time runs out!

Hemorrhage
An Interactive Fiction by Ben Leiken
Release 1 / Serial number 120313 / Inform 7 build 6G60 (I6/v6.32 lib 6/12N) SD

Left Atrium
The Atrium pulsates all around you, pumping red and white blood cells, platelets, and plasma southward towards the Right Ventricle.

You can see a Mitral Valve and an Electrostatic Stimulator here.

>take stimulator
Taken.

>go south
(first opening the Mitral Valve)
It seems to be locked.

>unlock valve
(with the Electrostatic Stimulator)
You unlock the Mitral Valve.

>go souht
You can't see any such thing.

>go south
(first opening the Mitral Valve)

Right Ventricle
The pulsation is more powerful here, as blood is directed westward towards the aorta and into the brain.

You can see a Mitral Valve and James the Amoeba here.

>go east
You can't go that way.

>go west
Aorta
The pressure in here is incredible! The Cerebral Cortex is ahead.

You can see a cholesterol deposit (closed) here.

>go north
Cerebral Cortex
There is blood pouring from a hole in the ceiling.

You can see a calcium deposit here.

>take deposit
Taken.

>go south
Aorta
The pressure in here is incredible! The Cerebral Cortex is ahead.

You can see a cholesterol deposit (closed) here.

>go east
Right Ventricle
The pulsation is more powerful here, as blood is directed westward towards the aorta and into the brain.

You can see a Mitral Valve and James the Amoeba here.

>give james deposit
Now James has the calcium deposit. He is delighted!

[Your score has just gone up by fifty points.]

* * *

>unlock valve
(with the Electrostatic Stimulator)
You unlock the Mitral Valve.

>go south
(first opening the Mitral Valve)

Left Ventricle
The pulsation is more powerful here, as blood is directed westward through the aortic valve, into the aorta, and into the brain. To the east is the pulmonary vein.

You can see a Mitral Valve, an Aortic Valve and James the Amoeba here.

>go west
(first opening the Aortic Valve)

Aorta
The pressure in here is incredible! The Cerebral Cortex is ahead.

You can see an Aortic Valve and a cholesterol deposit (closed) here.

* * *

>take stimulator
Taken.

>unlock mitral valve
(with the Electrostatic Stimulator)
You unlock the Mitral Valve.

>go south
(first opening the Mitral Valve)

Left Ventricle
The pulsation is more powerful here, as blood is directed westward towards the aorta and into the brain. To the east is the pulmonary vein.

You can see a Mitral Valve, an Aortic Valve and James the Amoeba here.

>go east
Pulmonary Vein
Oxygenated blood rushes past you towards the Left Ventricle. The Lungs are to the North.

>go north
You can't go that way.

>go east
Lungs
You witness Oxygen Molecules moving out of the Lungs and into the bloodstream.

You can see Don the Macrophage here.

>talk to don
That's not a verb I recognise.

>examine don
Your friend Don greets you warmly. He tells you he has a wire coil that he thinks you'll need.

>ask don for wire coil
You have the wire coil! You're one step closer to repairing the aneurysm
[Your score has just gone up by fifty points.]

>go west
Pulmonary Vein
Oxygenated blood rushes past you towards the Left Ventricle. The Lungs are to the North.

>go west
Left Ventricle
The pulsation is more powerful here, as blood is directed westward towards the aorta and into the brain. To the east is the pulmonary vein.

You can see a Mitral Valve, an Aortic Valve and James the Amoeba here.

>go west
(first opening the Aortic Valve)

Aorta
The pressure in here is incredible! The Cerebral Cortex is ahead.

You can see an Aortic Valve and a cholesterol deposit (closed) here.

>examine deposit
You see nothing special about the cholesterol deposit.

>open deposit
You open the cholesterol deposit, revealing a leaflet.

>read leaflet
The Aneurism is located ahead! You must find the heparin capsule and the wire coil! Hurry, Ming doesn't have much time!

>go north
Cerebral Cortex
There is a bulging, pulsating mass on the ceiling. It's the aneurism!

You can see an Aneurism and a calcium deposit here.

>take deposit
Taken.

>wire the aneurism with the coil
The Aneurism has been wired!

[Your score has just gone up by one hundred points.]

* * *

>take stimulator
Taken.

>open valve
It seems to be locked.

>unlock valve
(with the Electrostatic Stimulator)
You unlock the Mitral Valve.

* * *

>go south
(first opening the Mitral Valve)

Left Ventricle
The pulsation is more powerful here, as blood is directed westward through the aortic valve, into the aorta, and into the brain. To the east is the pulmonary vein.

You can see a Mitral Valve, an Aortic Valve and James the Amoeba here.

>examine james
A lumpy, surly-looking Amoeba. He asks you to find him a calcium deposit.

>go south
Right Ventricle
The ventricle is pulsating loudly as deoxygenated blood rushes past you into the pulmonary arteries. The Left Ventricle is to the north. The Inferior Vena Cava is to the south.

>go south
Inferior Vena Cava
Blood rushes past you towards the Right Ventricle. The Stomach is to the south.

>south
Stomach
Food particles, acids, and enzymes churn around you. Don't stay here long!

You can see Josh the Flesh-Eating Bacteria here.

>examine josh
Josh eyes you angrily and asks if you're lost because there's not much of use in here.

>go north
Inferior Vena Cava
Blood rushes past you towards the Right Ventricle. The Stomach is to the south.

>go north
Right Ventricle
The ventricle is pulsating loudly as deoxygenated blood rushes past you into the pulmonary arteries. The Left Ventricle is to the north. The Inferior Vena Cava is to the south.

>go north
Left Ventricle
The pulsation is more powerful here, as blood is directed westward through the aortic valve, into the aorta, and into the brain. To the east is the pulmonary vein.

You can see a Mitral Valve, an Aortic Valve and James the Amoeba here.

>go west
(first opening the Aortic Valve)

Aorta
The pressure in here is incredible! The Cerebral Cortex is ahead.

You can see an Aortic Valve and a cholesterol deposit (closed) here.

>open cholesterol deposit
You open the cholesterol deposit, revealing a leaflet.

>read leaflet
The aneurysm is located ahead! You must find the heparin capsule and the wire coil! Hurry, Ming doesn't have much time!

>go north
Cerebral Cortex
There is a bulging, pulsating mass on the ceiling. It's the aneurysm!

You can see an Aneurysm and a calcium deposit here.

>get calcium deposit
Taken.

>go north
Cerebellum
You are in the control center of Ming. Be careful, don't touch anything!

You can see a G-Protein Coupled Receptor, Alex the Interneuron and John the Virus here.

>examine alex
A friendly-looking Interneuron. He tells you he has the G-Protein

>ask for the G-protein
You can't see any such thing.

>ask for the G-p
You can't see any such thing.

>ask alex for the G-p
Now you have the G-Protein!

[Your score has just gone up by fifty points.]

>unlock g-protein couple receptor
I didn't understand that sentence.

>unlock receptor
What do you want to unlock the G-Protein Coupled Receptor with?

>unlock receptor with G-p
You unlock the G-Protein Coupled Receptor.

>go north
(first opening the G-Protein Coupled Receptor)

Salivary Gland
It's salty and moist in here. Saliva drips off the walls.

You can see a G-Protein Coupled Receptor and a heparin capsule here.

>pick up heparin capsule
Taken.

>go south
Cerebellum
You are in the control center of Ming. Be careful, don't touch anything!

You can see a G-Protein Coupled Receptor, Alex the Interneuron and John the Virus here.

>examine john
A shifty-looking Virus. He is holding a lysosome…

>go south
Cerebral Cortex
There is a bulging, pulsating mass on the ceiling. It's the aneurysm!

You can see an Aneurysm here.

>dose aneurysm with heperin
You can't see any such thing.

>dose aneurysm with heparin
The Aneurysm has been dosed with Heparin!

[Your score has just gone up by one hundred points.]

>go south
Aorta
The pressure in here is incredible! The Cerebral Cortex is ahead.

You can see an Aortic Valve and a cholesterol deposit (in which is a leaflet) here.

>go south
Left Ventricle
The pulsation is more powerful here, as blood is directed westward through the aortic valve, into the aorta, and into the brain. To the east is the pulmonary vein.

You can see a Mitral Valve, an Aortic Valve and James the Amoeba here.

>go east
Pulmonary Vein
Oxygenated blood rushes past you towards the Left Ventricle. The Lungs are to the east.

>go east
Lungs
You witness Oxygen Molecules moving out of the Lungs and into the bloodstream.

You can see Don the Macrophage here.

>examine don
Your friend Don greets you warmly. He tells you he has a wire coil that he thinks you'll need.

>ask don for wire
You have the wire coil! You're one step closer to repairing the aneurysm
[Your score has just gone up by fifty points.]

>go west
Pulmonary Vein
Oxygenated blood rushes past you towards the Left Ventricle. The Lungs are to the east.

>go west
Left Ventricle
The pulsation is more powerful here, as blood is directed westward through the aortic valve, into the aorta, and into the brain. To the east is the pulmonary vein.

You can see a Mitral Valve, an Aortic Valve and James the Amoeba here.

>go west
Aorta
The pressure in here is incredible! The Cerebral Cortex is ahead.

You can see an Aortic Valve and a cholesterol deposit (in which is a leaflet) here.

>go north
Cerebral Cortex
There is a bulging, pulsating mass on the ceiling. It's the aneurysm!

You can see an Aneurysm here.

>wire aneuyism with wire coil
You can't see any such thing.

>wire aneuryism with wire coil
You can't see any such thing.

>wire aneurysm with wire coil
The Aneurysm has been wired!

The Aneurysm has been treated! Ming will live.

    *** You have won ***

In that game you scored 300 out of a possible 0, in 38 turns.

Would you like to RESTART, RESTORE a saved game, QUIT or UNDO the last command?

* * *

>take stimulator
Taken.

>unlock mitral
(with the Electrostatic Stimulator)
You unlock the Mitral Valve.

>go south
(first opening the Mitral Valve)

Right Ventricle
The pulsation is more powerful here, as blood is directed westward towards the aorta and into the brain.

You can see a Mitral Valve and James the Amoeba here.

>go west
Aorta
The pressure in here is incredible! The Cerebral Cortex is ahead.

You can see a cholesterol deposit (closed) here.

* * *

>go east
Right Ventricle
The pulsation is more powerful here, as blood is directed westward towards the aorta and into the brain.

You can see a Mitral Valve and James the Amoeba here.

>give James the deposit
Now James has the calcium deposit. He is delighted!

* * *

>take stimulator
Taken.

>unlock valvue
You can't see any such thing.

>unlock valve
(with the Electrostatic Stimulator)
You unlock the Mitral Valve.

* * *

>take stimulator
Taken.

>unlock valve
(with the Electrostatic Stimulator)
You unlock the Mitral Valve.

* * *

>go south
(first opening the Mitral Valve)

Left Ventricle
The pulsation is more powerful here, as blood is directed westward through the aortic valve, into the aorta, and into the brain. To the east is the pulmonary vein.

You can see a Mitral Valve, an Aortic Valve and James the Amoeba here.

>go east
Pulmonary Vein
Oxygenated blood rushes past you towards the Left Ventricle. The Lungs are to the east.

You can see a Half-Sign sign here.

>read sign
To correctly repair the aneurysm, you must use a heparin capsule. To administer the heparin, use the custom command--dose aneurysm with heparin.

* * *

>go east
Pulmonary Vein
Oxygenated blood rushes past you towards the Left Ventricle. The Lungs are to the east.

You can see a Half-Sign sign here.

>go west
Aorta
The pressure in here is incredible! The Cerebral Cortex is ahead.

You can see a cholesterol deposit (closed) here.

* * *

>go south
Aorta
The pressure in here is incredible! The Cerebral Cortex is ahead.

You can see a cholesterol deposit (closed) here.

>go east
Right Ventricle
The pulsation is more powerful here, as blood is directed westward towards the aorta and into the brain.

You can see a Mitral Valve and James the Amoeva here.

>give James the Amoeva calcium deposit
You can only do that to something animate.

* * *

>go south
(first opening the Mitral Valve)

Left Ventricle
The pulsation is more powerful here, as blood is directed westward through the aortic valve, into the aorta, and into the brain. To the east is the pulmonary vein.

You can see a Mitral Valve, an Aortic Valve and James the Amoeba here.

>go south
Right Ventricle
The ventricle is pulsating loudly as deoxygenated blood rushes past you into the pulmonary arteries. The Left Ventricle is to the north. The Inferior Vena Cava is to the south.

>go outh
You can't see any such thing.

>go south
Inferior Vena Cava
Blood rushes past you towards the Right Ventricle. The Stomach is to the south.

>go south
Stomach
Food particles, acids, and enzymes churn around you. Don't stay here long!

You can see a sign and Josh the Flesh-Eating Bacteria here.

>read sign
To repair the aneurism you must use the wire coil! Repair it by using the custom command -- wire the aneurism with coil!

>talk to Josh
That's not a verb I recognise.

>examine josh
Josh eyes you angrily and asks if you're lost because there's not much of use in here.

* * *

>go south
Inferior Vena Cava
Blood rushes past you towards the Right Ventricle. The Stomach is to the south.

>go south
Stomach
Food particles, acids, and enzymes churn around you. Don't stay here long!

You can see an Other-Half Sign and Josh the Flesh-Eating Bacteria here.

>read sign
To repair the aneurysm you must use the wire coil! Repair it by using the custom command -- wire the aneurysm with coil!

>go north
Inferior Vena Cava
Blood rushes past you towards the Right Ventricle. The Stomach is to the south.

>go nort
You can't see any such thing.

>go north
Right Ventricle
The ventricle is pulsating loudly as deoxygenated blood rushes past you into the pulmonary arteries. The Left Ventricle is to the north. The Inferior Vena Cava is to the south.

* * *

>go north
Left Ventricle
The pulsation is more powerful here, as blood is directed westward through the aortic valve, into the aorta, and into the brain. To the east is the pulmonary vein.

You can see a Mitral Valve, an Aortic Valve and James the Amoeba here.

>go east
Pulmonary Vein
Oxygenated blood rushes past you towards the Left Ventricle. The Lungs are to the east.

You can see a Half-Sign here.

>read sign
You can't see any such thing.

* * *

>go south
(first opening the Mitral Valve)

Left Ventricle
The pulsation is more powerful here, as blood is directed westward through the aortic valve, into the aorta, and into the brain. To the east is the pulmonary vein.

You can see a Mitral Valve, an Aortic Valve and James the Amoeba here.

>go west
Aorta
The pressure in here is incredible! The Cerebral Cortex is ahead.

You can see a cholesterol deposit (closed) here.

>go north
Cerebral Cortex
There is a bulging, pulsating mass on the ceiling. It's the aneurism!

You can see an Aneurism, a wire coil, a heparin capsule and a calcium deposit here.

>take deposit
Taken.

* * *

>go east
Right Ventricle
The pulsation is more powerful here, as blood is directed westward towards the aorta and into the brain.

You can see a Mitral Valve and James the Amoeba here.

>talk to James
That's not a verb I recognise.

>examine James
A lumpy, surly-looking Amoeba. He asks you to find him a calcium deposit.

>give James calcium deposit
You can only do that to something animate.

* * *

>go south
Aorta
The pressure in here is incredible! The Cerebral Cortex is ahead.

You can see a cholesterol deposit (closed) here.

>go north
Cerebral Cortex
There is blood pouring from a hole in the ceiling.

* * *

>go north
Cerebral Cortex
There is a bulging, pulsating mass on the ceiling. It's the aneurism!

You can see an Aneurism, a wire coil, a heparin capsule and a calcium deposit here.

>take dposit
You can't see any such thing.

>take deposit
Taken.

* * *

>go east
Right Ventricle
The pulsation is more powerful here, as blood is directed westward towards the aorta and into the brain.

You can see a Mitral Valve and James the Amoeva here.

>give James calcium deposit
You can only do that to something animate.

>give James the Amoeba the calcium deposit
You can only do that to something animate.

* * *

>go north
Cerebral Cortex
There is a bulging, pulsating mass on the ceiling. It's the aneurism!

You can see an Aneurism, a wire coil, a heparin capsule and a calcium deposit here.

>take wire coil
Taken.

>wire the Aneurism with wire coil
That's not a verb I recognise.

>wiring the aneurism with wire coil
That's not a verb I recognise.

* * *

>take wire coil
Taken.

>wire aneurism with wire coil
hi there

* * *

>go north
Cerebral Cortex
There is a bulging, pulsating mass on the ceiling. It's the aneurism!

You can see an Aneurism, a wire coil, a heparin capsule and a calcium deposit here.

>take wire
Taken.

>take heparin
Taken.

>wire Aneurism
What do you want to wire the Aneurism with?

>wire
What do you want to wire?

>wire aneurism with wire coil
The Aneurism has been wired!

[Your score has just gone up by one hundred points.]

>dose the aneurism with heparin
The Aneurism has been dosed with Heparin!

The Aneurism has been treated! Ming will live.

    *** You have won ***

In that game you scored 200 out of a possible 0, in 9 turns.

Would you like to RESTART, RESTORE a saved game, QUIT or UNDO the last command?